playerPos
1
2
ghostPos
2
2
map
23
6
HHHHHH.HHHHHHHHHHHHHHHH
.........HHHH..........
...*.....H..H..........
.......................
.......................
HHHHHH.HHHHHHHHHHHHHHHH