playerPos
1
2
ghostPos
2
2
map
5
24
HHHHHHHHHHHHHHHHHHHHHHHH
H........HHHHHH........H
H........H....H........H
HHHHHHHHHHHHHHHHHHHHHHHH
12345....HHHHHH........H